たぶん	たぶん	可能、也许、大概
かどうか	かどうか	是不是、是否
気象予報士	きしょうよほうし	天气预报员
くもり	くもり	阴天
つけます	つけます	添加
気温	きおん	气温
下がります	さがります	下降
最高気温	さいこうきおん	最高气温
度	ど	度
死にます	しにます	死、死亡、消灭
よく	よく	不太
近い	ちかい	近
銀行	ぎんこう	银行
中国人	ちゅうごくじん	中国人
日本人	にほんじん	日本人
もうすぐ	もうすぐ	马上
物価	ぶっか	物价
上がります	あがります	上升
人口	じんこう	人口
増えます	ふえます	增加
減ります	へります	减少
続きます	つづきます	连续、继续
空	そら	天空
晴れます	はれます	晴、晴朗
曇ります	くもります	阴天
正しい	ただしい	正确
苦しい	くるしい	不舒服、困难、难受
景気	けいき	景气
ニュース	ニュース	新闻
本当	ほんとう	真实
話	はなし	说话、话
うそ	うそ	谎言、胡说
二人	ふたり	二人
良い	よい	好、良好
下がります	さがります	下降
