乗る	のる	乘坐、搭乘	
速さ	はやさ	快（的程度）	
丈夫さ	じょうぶさ	结实（的程度）、坚固（的程度）	
白衣	はくい	白色工作服、白罩衫	
Ｍサイズ	エムサイズ	Ｍ尺寸、Ｍ尺码	
メガネ眼鏡	めがね	眼睛	
探す［を］	さがす	找、寻找	
わあ	わあ	（感）哇、呀。表示吃惊或高兴时脱口而出的话。	
早い	はやい	早的、快的	
実験器具	じっけんきぐ	实验器具、实验工具	
え？	え？	（感）哎？	
研究生	けんきゅうせい	研修生，对语言、技能培训学习者的称呼。	
片付ける［を］	かたづける	收拾、整理	
ミリメートル	ミリメートル	mm，毫米	
センチメートル	センチメートル	cm，厘米	
メートル	メートル	m，米	
キロメートル	キロメートル	km，千米、公里	
インチ	インチ	inch，英寸	
ヤード	ヤード	yaid，码	
マイル	マイル	mile，英里、哩	
重さ	おもさ	重、重的程度	
グラム	グラム	g，克	
キログラム	キログラム	kg，千克、公斤	
ミリグラム	ミリグラム	mg，毫克	
オンス	オンス	ounce，盎司，28.35克	
ポンド	ポンド	pound，英镑	
トン	トン	t，吨	
面積	めんせき	面积	
平方メートル	へいほうメートル	㎡，平方米	
平米	へいべい	平方米	
エーカー	エーカー	acre，英亩，一英亩约合4047㎡	。
坪	つぼ	坪，用于丈量房屋和宅地面积，1坪约等于3.3m*m	。
体積	たいせき	体积	
方	りっぽう	立方；立方体；立方米	
リットル	リットル	litter，升、公升	
ガロン	ガロン	gallon，加仑（容量单位）	
合	ごう	合，日本容积单位。1合大约是0.18升。	
升	しょう	升，日本容积单位。1升等于10合。	
速さ	はやさ	快的程度，速度	
秒速	びょうそく	秒速，一秒钟的速度	
分速	ふんそく	分速，一分钟的前进速度	
時速	じそく	时速，每小时前进的速度	
80km/時	［じそく/まいじ］80キロメートル	80km/时，每小时80公里的速度	
泊まる［に］	とまる	住宿、住下	
旅館	りょかん	旅馆	
着く［に］	つく	到、到达	
入る［に］	はいる	进、进入	
お風呂	おふろ	浴盆；浴室；洗澡	
座る［に］	すわる	坐、坐下	
席	せき	位子、席位	
登る［に］	のぼる	登、攀登	
立つ	たつ	站、立	
止まる［に］	とまる	停止、停下、停靠	
停留所	ていりゅうじょ	车站、公交车站	
入学する［に］	にゅうがくする	入学	
東京大学	とうきょうだいがく	东京大学	
入院する［に］	にゅういんする	住院	
大学病院	だいがくびょういん	大学附属医院	
入社する［に］	にゅうしゃする	进入公司工作	
新聞社	しんぶんしゃ	报社	
出版社	しゅっぱんしゃ	出版社	
出席する［に］	しゅっせきする	出席	
会議	かいぎ	会议	
乗る［に］	のる	乘坐、搭乘	
オートバイ	オートバイ	摩托车	
特急	とっきゅう	特别快车	
急行	きゅうこう	快车	
各駅停車	かくえきていしゃ	各站停车、慢车	
エレベーター	エレベーター	电梯	
エスカレーター	エスカレーター	自动扶梯	
～番線	～ばんせん	～号线	
ちょっと困ります	ちょっとこまります	不好办，委婉地表达禁止的说法。	
やめる［を］	やめる	停止、作罢；放弃、取消	
絶対に	ぜったいに	绝对，表示说话人的强烈主张。	
忘れる［を］	わすれる	忘、忘记	
ガラス	ガラス	玻璃	
割る［を］	わる	弄坏、扎坏、打碎	
壊す［を］	こわす	弄坏、砸坏、打碎	
石	いし	石头、石子	
投げる［を］	なげる	扔、投、掷	
折る［を］	おる	折、折断	
なくす［を］	なくす	丢失、失掉	
破る［を］	やぶる	撕破、弄坏	
必ず	かならず	一定、必定	
間違える［を］	まちがえる	弄错；弄坏	
浅い	あさい	浅、浅的	
深い	ふかい	深、深的	
がんばる	がんばる	加油、顽强坚持	
広い	ひろい	宽广、宽敞	
狭い	せまい	狭窄的、窄小的	
一人で	ひとりで	一个人做某事	
けんか	けんか	吵架、争吵	
いいえ、大丈夫です	いいえ、だいじょうぶです	不，没问题	
心配する［を］	しんぱい	担心	
メモ	メモ	笔记、记录	
はかる［を］	はかる	计量、测量	
レポート	レポート	报告、小论文	
コップ	コップ	玻璃杯、杯子	
