教室	きょうしつ	教室
どれ	どれ	どれ
どの	どの	どの
ここ	ここ	ここ
どこ	どこ	どこ
そこ	そこ	そこ
あそこ	あそこ	あそこ
図書館	としょかん	图书馆
建物	たてもの	建筑物
体育館	たいいくかん	体育馆
工学部	こうがくぶ	工学院系
研究室	けんきゅうしつ	研究室
中村先生	なかむらせんせい	中村先生
こちら	こちら	这边、这位；我们
名刺	めいし	名片
ね	ね	ね
では	では	那么
失礼します	しつれいします	失礼、不礼貌；告辞、再见；对不起
机	つくえ	桌子
パソコン	パソコン	电脑
トイレ	トイレ	厕所
カメラ	カメラ	照相机
ラジオ	ラジオ	收音机
テレビ	テレビ	电视
いす	いす	椅子
テーブル	テーブル	桌子、餐桌
地図	ちず	地图
ドイツ	ドイツ	德国
金	きん	姓 金
シャープペン	シャープペン	自动铅笔
京都	きょうと	京都
日本	にほん	日本
漢字	かんじ	汉字
事務室	じむしつ	办公室、事务所
食堂	しょくどう	食堂
ホテル	ホテル	旅店
郵便局	ゆうびんきょく	邮电局
銀行	ぎんこう	银行
病院	びょういん	医院
バス停	バスてい	公共汽车站
バス	バス	公共汽车
寮	りょう	宿舍
電話番号	でんわばんごう	电话号码
何番	なんばん	多少号
マレーシア	マレーシア	马来西亚
