たぶん	たぶん	大概、或许
音読み	おんよみ	音读
こっち	こっち	这儿、这边
そっち	そっち	那儿、那边
あっち	あっち	那儿、那边
どっち	どっち	哪儿、哪边
さあ	さあ	劝诱别人或表示为难时的话语
向く［を］	むく	向，朝
チーズ	チーズ	奶酪
笑う	わらう	笑
数字	すうじ	数字
お久しぶりです	おひさしぶりです	好久不见
おかげさまで	おかげさまで	托您的福
予約	よやく	预约
～名様	～めいさま	～位客人
かしこまりました	かしこまりました	明白了
陳文新	ちんぶんしん	陈文新
お～	お～	向对方或第三者表达尊敬的语气
はあ？	はあ？	啊？
おっしゃる	おっしゃる	「言う」的尊敬语
こざと偏	こざとへん	耳刀旁
東	ひがし	东
書く	かく	写
陳述	ちんじゅつ	陈述
文章	ぶんしょう	文章
失礼いたしました	しつれいいたしました	失礼了
～でいらっしゃいます	～でいらっしゃいます	「です」的恭敬用法
御予約	ごよやく	您的预约
確かに	たしかに	的确、确实
承りました	うけたまわりました	接受，答应，听「引き受ける」「承諾する」「聞く」的谦让语，多用于服务行业场合。
事故	じこ	事故
戻る［に／へ］	もどる	返回
謝る［に］	あやまる	道歉
お礼	おれい	感谢、道谢
帰国する［に／へ］	きこくする	回国
あいさつ	あいさつ	寒暄
意見	いけん	意见
皆	みな	大家，全部
出かける	でかける	外出
～か、～か、～	～か、～か、～	……，还是不……
答え	こたえ	答案
正しい	ただしい	正确
番組	ばんぐみ	节目
ニュース	ニュース	新闻
本当	ほんとう	真的
楽な	らくな	轻松的
うそ	うそ	谎话
間違い	まちがい	错误，过错
（うそを）つく	（うそを）つく	说谎
ごめんなさい	ごめんなさい	对不起
頼む[に][を]	たのむ	拜托，请求
警察官	けいさつかん	警察
尋ねる[に][を]	たずねる	询问、打听
意味	いみ	意思、意思
知らせる[に][を]	しらせる	通知、告知
景気	けいき	景气、有活力
論文	ろんぶん	论文
できる	できる	能，会
物価	ぶっか	物价
下がる	さがる	下降
状態	じょうたい	状态
平和な	へいわな	和平
書類	しょるい	文件，资料
訓読み	くんよみ	训读
音読み	おんよみ	音读
山	やま	山
れい	れい０（＝ゼロ）	零
～と申します	～ともうします	我叫……
正	ただし	正（人名）
あき子	あきこ	人名（女子）
王麗	おうれい	王丽
