かく	かく	画
絵	え	绘画、画
昨日	さくじつ	昨天（「きのう」的郑重说法）
風邪	かぜ	感冒、伤风
（風邪を）ひく	ひく	患（感冒）、得（感冒）
～からです	～からです	因为……（参考文型12）
こういう～	こういう～	这样的（参考型11）
そういう～	そういう～	那样的（参考型11）
ああいう～	ああいう～	那样的（参考型11）
どういう～	どういう～	怎么样的（参考型11）
看板	かんばん	招牌，广告牌
月極	つきぎめ	按月（交钱）、
料金	りょうきん	费用，使用费
払う［に］［を］	はらう	支付、交纳
あんな	あんな	那样的
当て字	あてじ	假借字、借用字
全然（～ない）	ぜんぜん	全然不……，根本不……
（私も）同感です	どうかんです	同感
置き時計	おきどけい	座钟
選ぶ［を］	えらぶ	选择，挑选
そんな	そんな	那样的
見送る［を］	みおくる	送别、送行
避ける［を］	さける	避开、避免
習慣	しゅうかん	习惯
死	し	死、死亡、去世
万年筆	まんねんひつ	钢笔
発音練習	はつおんれんしゅう	发音练习
感じ	かんじ	感觉，知觉
若い	わかい	年轻，年少
ペン	ペンpen	钢笔
このごろ	このごろ	最近、如今、近来
代わりに	かわりに	代替，取而代之
特に	とくに	特别
アパート	アパートapartment-house	公寓
寮費	りょうひ	宿舍费、住宿费
住む［に］	すむ	住、居住
真ん中	まんなか	正中间、正当中
燃える	もえる	燃烧，着火
布	ぬの	布
縮む	ちぢむ	缩、缩短、缩小
ボール	ボールball	球
虫	むし	虫，昆虫
鳴く	なく	叫，鸣叫
溶ける	とける	溶化，溶解
組み立てる［を］	くみたてる	装配，构成，组织
故障	こしょう	故障
お茶の葉	おちゃのは	茶叶
セーター	セーターsweater	毛衣
編む［を］	あむ	编，织
村上春樹	むらかみはるき	村上春树
小説	しょうせつ	小说
勤める［に］	つとめる	工作
交通事故	こうつうじこ	交通事故
建てる［に］［を］	たてる	盖、建造、修建
メンバー	メンバーmember	成员
反対する［に］	はんたいする	反对，相反、反面
賛成する［に］	さんせいする	赞成
愛する［を］	あいする	爱、爱慕，热爱
秘密	ひみつ	秘密
マンション	マンションmansion	高级公寓
運ぶ［に］［を］	はこぶ	搬、运，进展
竹	たけ	竹子
植物	しょくぶつ	植物
地方	ちほう	地方，地区（指首都及相当于首都的大城市以外的地区。有时表示“乡下”）
乗り物	のりもの	交通工具
モノレール	モノレールmonorail	单轨电车，单轨铁路
翻訳	ほんやく	翻译（笔译），译本
こんな	こんな	这样的（参考型11）
どんな	どんな	那样的（参考型11）
そんな	そんな	那样的（参考型11）
あんな	あんな	怎么样的（参考型11）
用事	ようじ	（应办的）事情，工作
痛い	いたい	（肉体的）疼、痛，（心里）痛苦、难受
つまらない	つまらない	无聊、乏味、没意思
