象	ぞう	大象	
鼻	はな	鼻子	
すく	（おなかが）すく	（肚子）饿，空	
におい	におい	味儿，气味儿	
する[が](無意志動詞）	する	有??感觉	
屋上	おくじょう	屋顶、房顶	
見える	みえる	看见、看得见	
やっと	やっと	好容易、终于	
ごちそうする[を]	ごちそうする[を]	请客、款待	
いらっしゃいませ	いらっしゃいませ	欢迎	
何名様ですか	なんめいさまですか	几位？	
禁煙席	きんえんせき	禁烟席	
富士山	ふじさん	富士山	
注文する[を]	ちゅうもんする	订货、订购	
おいしい	おいしい	好吃的、美味的	
メニュー	メニュー	菜单、菜谱	
お持ちする[を]	おもちする	（给您）拿	
おしぼり	おしぼり	湿巾、热毛巾	
体	からだ	身体	
頭	あたま	头、脑袋	
首	くび	颈、脖子	
胸	むね	胸、胸部	
おなか	おなか	肚子	
脚	あし	腿	
足	あし	脚	
髪の毛	かみのけ	头发	
耳	みみ	耳朵	
眉	まゆ	眉毛	
目	め	眼睛	
鼻	はな	鼻、鼻子	
口	くち	口、嘴	
腕	うで	胳膊；本事	
指	ゆび	手指	
象	ぞう	大象	
パンダ	パンダ panda	熊猫	
丸い	まるい	圆的	
スピード	スピードspeed	速度	
三角	さんかく	三角形	
四角	しかく	四角形、方形	
寺	てら	寺庙、寺院	
歴史	れきし	历史	
面積	めんせき	面积	
量	りょう	量	
数	かず	数量、数目	
味	あじ	味道	
痛い	いたい	疼、疼痛	
背中	せなか	背、脊背	
のど	のど	喉咙、嗓子	
歯	は	牙、牙齿	
苦しい	くるしい	痛苦、难受	
だるい	だるい	发倦、发酸、慵懒	
手足	てあし	手脚	
具合	ぐあい	情况、状态	
渇く	かわく	渴、干渴	
いっぱい	いっぱい	满、充满	
しびれる	しびれる	麻、麻木	
する（吐き気）［が］	する	（想要呕吐的）感觉	
吐き気	はきけ	恶心、想要呕吐	
寒気	さむけ	感到寒冷	
目まい	めまい	头晕、眼花	
甘い	あまい	甜的	
辛い	からい	辣的；咸的	
塩辛い	しおからい	咸的	
酸っぱい	すっぱい	酸的	
苦い	にがい	苦的	
変な	へんな	怪，古怪的，异常	
くさい	くさい	臭，难闻的	
生ごみ	なまごみ	（厨房扔掉的）垃圾、生活垃圾	
冷たい	つめたい	冷、凉	
感じ	かんじ	感觉	
温かい	あたたかい	暖、温暖的	
怖い	こわい	可怕的、令人害怕	
警官	けいかん	警察	
落ち着く	おちつく	沉着、镇静、稳重	
隣	となり	邻居、隔壁	
近く	ちかく　ちかく	近处、附近	
かわいい	かわいい	可爱、讨人喜欢的	
海岸	かいがん	海岸	
船	ふね	船	
窓	まど	窗、窗户	
海	うみ	大海、海洋	
汽車	きしゃ	火车、列车	
森	もり	树林、森林	
湖	みずうみ	湖	
向こう	むこう	前面、正面、正对面	
星	ほし	星	
遠く	とおく	远处	
聞こえる	きこえる	听得见、听得到	
話し声	はなしごえ	说话声	
泣き声	なきごえ　なきごえ	哭声	
～の方	～のほう	～方、～方向	
花火	はなび	焰火、礼花	
にぎやかな	にぎやかな	热闹、繁华	
草の間	くさのあいだ	草丛	
けんか	けんか	吵架、打架	
廊下	ろうか	走廊	
足音	あしおと	脚步声	
会場	かいじょう	会场	
拍手	はくしゅ	拍手、鼓掌	
力	ちから	力气、力量	
ある［は］［が］	ある	有	
金持ち	かねもち	有钱的人、富人	
暇	ひま	闲空、余暇；工夫	
お年寄り	おとしより	老人	
問題	もんだい	问题；题	
危ない	あぶない	危险的；令人担心的、靠不住的	
身長	しんちょう	身高	
体重	たいじゅう	体重	
熱	ねつ	热、热度；发烧	
