もし	もし	如果	
～たら～	～たら～	要是…… 的话，如果…… 的话	
宝くじ	たからくじ	彩票	
当たる［に］	あたる	中（彩票）、中奖	
注文する［を］	ちゅうもん	点餐；定做、订购	
よろしいですか	よろしいですか	……可以吗？「いいですか。」的郑重表达。	
～かな	～かな	表示疑问或不明确的心情	
～だけ	～だけ	仅仅、只有	
頼む［を］	たのむ	点餐；定做、订购	
おなかいっぱい	おなかいっぱい	吃饱了	
そろそろ	そろそろ	该；就要；快	
お開きにする	おひらきにする	结束（集会、宴会结束时为避免不吉利，采用此种表达）	
割り勘	わりかん	AA制、分摊、均摊	
富士山	ふじさん	富士山	
賛成	さんせいする	赞成	
出かける[に／へ]	でかける	出门、出去；向着某处出发	
晴れる	はれる	晴天	
うまくいく	うまくいく	顺利，“顺利进行”的意思。口语	
皆	みな	全体、大家；全、都	
列車	れっしゃ	列车、火车	
ふるさと	ふるさと	故乡、家乡	
聞き取る[を]	ききとる	听清；听懂；听取	
ひどい	ひどい	厉害、激烈、凶猛；残酷、太过分	
痛い	いたい	疼、痛	
複雑な	ふくざつな	复杂的	
危険な	きけんな	危险的	
条件	じょうけん	条件	
昼間	ひるま	白天、日间	
動かし方	うごかしかた	操作方式、运转方式	
アプリ	アプリ application program	应用程序、应用程式	
退院する	たいいんする	出院	
集まる［に］	あつまる	集合、会和	
出発する	しゅっぱつする	出发	
ベル	ベル	铃；电铃	
鳴る	なる	响；鸣	
コンパ	コンパ	聚会、联欢会（大学生等彼此交一定的费用举行的联欢会）	
うれしい	うれしい	高兴、喜悦	
一番になる	いちばんになる	第一	
春節	しゅんせつ	春节	
治る	なおる	治愈、痊愈、恢复	
顔色	かおいろ	脸色	
肉	にく	肉	
（においが）する	（においが）する	感觉到声、色、形、味等；有（气味）	
捨てる［に］［を］	すてる	扔掉、倒；放弃、舍弃	
枯れる	かれる	枯萎、凋零；干涸、枯竭	
悪いことをする	わるいことをする	做坏事	
叱る［を］	しかる	批评、责备	
いいことをする	いいことをする	做好事	
ほめる［を］	ほめる	表扬、赞扬	
帰国	きこく	回国	
指導教員	しどうきょういん	指导教师、导师	
濡れる	ぬれる	淋湿	
乾かす	かわかす	晒干、晾干；烘干	
腐る	くさる	腐烂、烂、坏	
急ぐ	いそぐ	赶紧、赶忙、加快	
（音を）立てる	（おとを）たてる	出（声）、发出（声音）	
避ける［を］	さける	避、避开	
