一度も～ない	いちども	一次也没～						
何度も	なんども	很多次都～						
こんな～	こんな～	这么～						
そんな～	そんな～	那么～						
あんな～	あんな～	那么～						
どんな～	どんな～	什么～、什么样的						
たいてい	たいてい	大抵、十有八九						
クックパッド	クックパッド cookpad	检索料理做法的网站。不仅专业人士可以投稿，普通人也可以投稿。						
今度	こんど	这回；下回						
体の調子	からだのちょうし	身体状况						
（病気を）する	（びょうきを）する	生病						
風邪	かぜ	感冒、伤风						
ひく[風邪を]	ひく	患（感冒）						
(若い）ころ	（わかい）ころ	（年轻）时候						
数学オリンピック	すうがくオリンピック Olympic	数学奥林匹克						
けが	けが	受伤						
交通事故	こうつうじこ	交通事故						
遭う［に］	あう	遭遇						
けがをする	けがをする	受伤						
マンガ	マンガ	漫画						
忘れ物をする	わすれものをする	忘东西了						
他人	たにん	他人						
迷惑	めいわく	麻烦						
(迷惑を）かける［に］	（めいわくを）かける	添麻烦						
朝寝坊をする	あさねぼうをする	睡懒觉						
（一度）だけ	（いちど）だけ	仅（一次）						
落とす［を］	おとす	遗失、丢掉；使落下，使降落						
（一度）しか～ない	（いちど）しか	只有（一次）						
徹夜をする	てつやをする	熬夜						
夢	ゆめ	梦，梦想						
動画	どうが	动画片						
ちゃんと	ちゃんと	按期，整整齐齐						
きつい	きつい	紧紧的、没有空隙的；强烈的；费力的						
チェック	チェック　check	检查						
調子	ちょうし	状况、状态；势头、劲头；调子						
助かる	たすかる	得救、脱险；省事、变轻松						
手術	しゅじゅつ	手术						
（手術を）受ける	（しゅじゅつを）うける	做手术（病人接受手术）						
成功する	せいこうする	成功						
ぼんおどり	ぼんおどり	盂兰盆舞						
