きのう	きのう	昨天
買いました	かいました	买了
公園	こうえん	公园
で	で	で场所
写真	しゃしん	照片
を	を	を
撮りました	とりました	拍照了
皆さん	みなさん	各位、诸位
ガイドブック	ガイドブック	参考手册
見てください	みてください	请看
きょう	きょう	今天
パーティー	パーティー	宴会
午後	ごご	午后
プレースメントテスト	プレースメントテスト	能力测试、分班考试
号館	ごうかん	号馆
わかります	わかります	知道、明白
が	が	转折
わかりました	わかりました	知道了
秋葉原	あきはばら	秋叶原
えっ	えっ	什么？
あした	あした	明天
宿題	しゅくだい	作业
掃除	そうじ	扫除、打扫
今朝	けさ	今天早晨
洋服	ようふく	西服
洗濯	せんたく	洗衣服
ゆうべ	ゆうべ	昨晚
今晩	こんばん	今晚
来週	らいしゅう	下周
仕事	しごと	工作
来月	らいげつ	下个月
実験	じっけん	实验
去年	きょねん	去年
おととい	おととい	前天
今日	きょう	今天
運動	うんどう	运动、体育项目
台所	だいどころ	厨房
スーパー	スーパー	超市
運動場	うんどうじょう	运动场
先週	せんしゅう	上周
今晩	こんばん	今天晚上
食事	しょくじ	吃饭
あした	あした	明天
あさって	あさって	后天
掃除します	そうじします	扫除、打扫
さ来週	さらいしゅう	下下周
毎週	まいしゅう	每周
先々週	せんせんしゅう	大上周
さ来月	さらいげつ	下下月
毎月	まいつき	每月
先々月	せんせんげつ	大上个月
来年	らいねん	明年
さ来年	さらいねん	后年
毎年	まいとし	每年
おととし	おととし	前年
新宿	しんじゅく	新宿
銀座	ぎんざ	银座
