でした	でした	でした
休み	やすみ	休息
ではありませんでした	ではありませんでした	ではありませんでした
へ	へ	へ
行きます	いきます	去
時	じ	点
に	に	に
一緒に	いっしょに	一起
一人で	ひとりで	一个人
お先に失礼します	おさきにしつれいします	我先走了
また明日	またあした	明天见
研究生	けんきゅうせい	进修生
金子	かねこ	金子
機械工学	きかいこうがく	机械工学
来ます	きます	来
研究	けんきゅう	研究
ご	ご	ご
家族	かぞく	家属
先輩	せんぱい	前辈
子供	こども	小孩
何歳	なんさい	几岁
おととし	おととし	前年
歳	さい	岁
生まれます	うまれます	出生
月曜日	げつようび	星期一
火曜日	かようび	星期二
水曜日	すいようび	星期三
木曜日	もくようび	星期四
金曜日	きにょうび	星期五
土曜日	どようび	星期六
日曜日	にちようび	星期日
何曜日	なんようび	星期几
誕生日	たんじょうび	生日
1月	いちがつ	1月
2月	にがつ	2月
3月	さんがつ	3月
4月	しがつ	4月
5月	ごがつ	5月
6月	ろくがつ	6月
7月	しちがつ	7月
8月	はちがつ	8月
9月	くがつ	9月
10月	じゅうがつ	10月
11月	じゅういちがつ	11月
12月	じゅうにがつ	12月
何月	なんがつ	几月
春	はる	春
夏	なつ	夏
秋	あき	秋
冬	ふゆ	冬
昼休み	ひるやすみ	午休
春休み	はるやすみ	春假
夏休み	なつやすみ	暑假
秋休み	あきやすみ	秋假
冬休み	ふゆやすみ	寒假
おととい	おととい	前天
きのう	きのう	昨天
今日	きょう	今天
あした	あした	明天
あさって	あさって	后天
毎日	まいにち	每天
今朝	けさ	今天早晨
ゆうべ	ゆうべ	傍晚
今晩	こんばん	今天晚上
今夜	こんや	今夜
先週	せんしゅう	上周
今週	こんしゅう	本周
来週	らいしゅう	下周
さ来週	さらいしゅう	下下周
毎週	まいしゅう	每周
時々	ときどき	时常
いつ	いつ	何时
先月	せんげつ	上个月
今月	こんげつ	这个月
来月	らいげつ	下个月
さ来月	さらいげつ	下下个月
毎月	まいつき	每月
去年	きょねん	去年
今年	ことし	今年
来年	らいねん	明年
さ来年	さらいねん	后年
毎年	まいとし	每年
デパート	デパート	百货商店
授業	じゅぎょう	上课
帰ります	かえります	回去
本屋	ほんや	书店
男の子	おとこのこ	男孩子
女の子	おんなのこ	女孩子
