に	に	に
が	が	が
あります	あります	あります
下	した	下
牛	うし	牛
います	います	在
上	うえ	上
冊	さつ	册
や	や	や
か	か	か
もしもし	もしもし	喂
そば	そば	附近
コンビニ	コンビニ	便利店
じゃ	じゃ	那么
また	また	还
おじゃまします	おじゃまします	打扰了
冷蔵庫	れいぞうこ	冰箱
卵	たまご	蛋
ハム	ハム	火腿
個	こ	个
枚	まい	张
サンドイッチ	サンドイッチ	三明治
たくさん	たくさん	很多
海	うみ	海
川	かわ	河
鳥	とり	鸟
箱	はこ	盒子
中	なか	中
外	そと	外
後ろ	うしろ	后
前	まえ	前
横	よこ	旁边
間	あいだ	之间
向こう	むこう	对面
木	き	树
池	いけ	池
猫	ねこ	猫
花	はな	花
ベッド	ベッド	床
袋	ふくろ	口袋
みかん	みかん	橘子
たんす	たんす	衣柜
服	ふく	衣服
棚	たな	架子
匹	ひき	匹
会社	かいしゃ	公司
電話	でんわ	电话
靴	くつ	鞋子
肉	にく	肉
ギョーザ	ギョーザ	饺子
